0000000000000000000000000000000000000000
0000000000000000000000000000000000000000
0000000000000000000000000100000000000000
0000000000000000000000010100000000000000
0000000000000110000001100000000000011000
0000000000001000100001100000000000011000
0110000000010000010001100000000000000000
0110000000010001011000010100000000000000
0000000000010000010000000100000000000000
0000000000001000100000000000000000000000
0000000000000110000000000000000000000000
0000000000000000000000000000000000000000
0000000000000000000000000000000000000000
